###########################
# # P # ###########       #
# #   # #         #       #
#     # #   ###   #       #   
#     ###   #     #       #
#           #             #
#  # ########           X #
###########################