###########################
# # P #                   #
# #   #                   #
#     #                   #
#     ##                  #
#                         #
#  # # #                X #
###########################