###########################
# # P #                   #
#                         #
#                         #
#                         #
#                         #
#                       X #
###########################